17 16 16 15 16 17 17 16 15 15 17 17 15 16 16 15 16 15 16 17
14 14 14 14 14 14 14 14 14 14 14 14 14 14 14 14 14 14 14 14
13 13 13 13 13 13 13 13 13 13 13 13 13 13 13 13 13 13 13 13
1 6 6 6 6 6 6 6 11 9 8 6 6 6 6 6 6 6 6 1
1 6 6 6 6 6 6 6 12 6 7 6 6 6 6 6 6 6 6 1
1 6 6 6 6 6 6 6 6 6 6 6 6 6 6 6 6 6 6 1
1 6 6 6 6 6 6 6 6 6 6 6 6 6 6 6 6 1 6 1 
1 6 6 6 6 6 6 6 6 6 6 6 6 6 6 6 6 1 6 1 
1 6 6 6 6 6 6 6 6 6 6 6 6 6 6 6 1 1 6 1 
1 6 6 6 6 6 6 6 6 6 6 6 6 6 6 6 1 6 6 1 
1 6 6 6 6 6 6 6 6 6 6 6 6 6 6 6 1 1 6 1 
1 6 6 6 6 6 6 6 6 6 6 6 6 6 6 6 1 6 6 1 
1 6 6 6 6 6 6 6 6 6 6 6 6 6 6 6 1 1 6 1 
1 6 6 6 6 6 6 6 6 6 6 6 6 6 6 6 6 1 6 1 
1 1 1 1 1 1 1 1 1 1 1 1 1 1 1 1 1 1 1 1