1 1 1 1 1 1 1 1 1 1 1 1 1 1 1 1 1 1 1 1
1 1 1 1 1 1 1 1 1 1 1 1 1 1 1 1 1 1 1 1
1 5 5 5 5 5 3 5 5 5 5 3 5 5 5 5 4 4 2 1
1 5 5 5 5 5 3 5 5 5 5 5 5 5 5 4 4 4 2 1
1 5 5 5 5 5 3 5 5 5 5 3 5 5 5 5 4 4 2 1
1 5 5 5 5 5 3 3 3 3 3 3 5 5 5 5 5 4 2 1
1 5 5 5 5 5 5 5 5 5 5 5 5 5 5 5 4 4 2 1
1 5 5 5 5 5 5 5 5 5 5 5 5 5 5 5 4 4 2 1
1 5 5 5 5 5 5 5 5 5 5 5 5 5 5 5 5 4 2 1
1 5 5 5 5 5 5 5 5 5 5 5 5 5 5 5 5 4 2 1
1 5 5 5 5 5 5 5 5 5 5 5 5 5 5 5 4 4 2 1
1 5 5 5 5 5 5 5 5 5 5 5 5 5 5 5 4 4 2 1
1 5 5 5 5 5 5 5 5 5 5 5 5 5 5 5 4 4 2 1
1 5 5 5 5 5 5 5 5 5 5 5 5 5 5 5 5 4 2 1
1 1 1 1 1 1 1 1 1 1 1 1 1 1 1 1 1 1 1 1